111111111111
1C010C010001
1201C1C10C01
1C02010C0001
120101C10C01
1001C10102C1
1PC10C010E01
111111111111
