111111111111111111111111111111
100000000000000000000C00000001
100000000000000000000C00000001
100000000C00000000000100000001
100000111111000000000100000001
1000001000010000000C0100000001
100000100001000000111100000001
100000111111000000000100000001
100000000000000000000100000001
1000000C00000C0000000100000001
100000000100111110000100000001
100000000000000000000100000001
100000000000000000000100000001
10P000C000000C000000010E000001
111111111111111111111111111111
