1111111111111111111111
100P000000000000000001
1000000000000000000001
1000000000000000000001
1000001111110000000001
1000001000010000000001
1000001000010000000001
1000001111110000000001
1000000000000000000001
1000000CE0000000000001
1000000001001000000001
1000000000000000000001
1000000000000000000001
1111111111111111111111
