1111111111111111111111
100P0C0000000000000001
1000000000000000000001
1000000000000000000001
1000001111110000000001
1000001000010000000001
1000001E00010000000001
1000001111110000000001
1000000000000000000001
1000000000000000000001
1000000000000000000001
1000000000000000000001
1000000000000000000001
1111111111111111111111
