111111111111
1C010C010001
100101010001
100001000001
100101010001
1001010100C1
1PC10C010E01
111111111111
