111111111111
1C010C010001
1001C1C10C01
1C0C010C0001
100101C10C01
1001C10100C1
1PC10C010E01
111111111111
