11111111
100E0001
10000001
100C0001
100P0001
11111111
