11111111
100E0011
100C0011
10000001
100P0001
11111111
