11111111111111
100P000E00C001
11111100011111
11111111111111
